Grapheme	IPA
a	ə
ã	ə̃
ā	aː
ã̄	ãː
ᶦ	ɪ
i	ɪ
ï	ɪ
ĩ	ɪ̃
ī	iː
ī˜	ĩː
u	ʊ
ũ	ʊ̃
ū	uː
ū̃	ũː
e	eː
ẽ	ẽː
o	oː
õ	õː
ai	ɛː
aĩ	ɛ̃ː
au	ɔː
aũ	ɔ̃ː
k	k
kh	kʰ
g	g
gh	gʱ
ṅ	ŋ
c	t͡ʃ
ch	t͡ʃʰ
j	d͡ʒ
jh	d͡ʒʱ
ñ	ɲ
t	t̪
th	t̪ʰ
d	d̪
dh	d̪ʱ
n	n
ṭ	ʈ
ṭh	ʈʰ
ḍ	ɖ
ḍh	ɖʱ
ṇ	ɳ
p	p
ph	pʰ
b	b
bh	bʱ
y	j
r	ɾ
l	l
v	ʋ
w	ʋ
s	s
ś	ʃ
ṣ	ʂ
h	ɦ
ṛ	ɽ
x	x
m	m
–	
g̠	ɠ
ḍ̠	ᶑ
j̄	ʄ
ḇ	ɓ