Grapheme	IPA
p	p
b	b
bh	bʱ
f	f
v	v
w	w
m	m
ü	ü
ü	ü
-	
u	u
ö	ö
o	o
û	u̬
ô	o̬
ć	t͡s
ź	d͡z
źh	d͡zʱ
t	t̪
d	d̪
dh	d̪ʱ
s	s
z	z
l	l
ɬ	ɬ
n	n
c̣	ʈ͡ʂ
j̣	ɖ͡ʐ
J̣	ɖ͡ʐ
j̣h	ɖ͡ʐʱ
ṭ	ʈ
ḍ	ɖ
ḍh	ɖʱ
ṣ	ʂ
ẓ	ʐ
r	ɾ
ṛ	ɽ
ḷ	ɭ
ř	ɻ
ň	ɻ̃
ṇ	ɳ
r̥	ɻ̩
č	t͡ʃ
ǰ	d͡ʒ
ǰh	d͡ʒʱ
š	ʃ
ž	ʒ
y	j̣
i	i
e	e
ä	ä
î	i̬
ê	e̬
k̂	kʲ
ĝ	gʲ
ĝh	gʲʱ
k	k
g	g
gh	gʱ
x	x
ǧ	ɣ
ʱ	ʱ
ʷ	ʷ
ŋ	ŋ
ï	ï
a	ə
â	ɑ
å	a
q	q
ḥ	ħ
ʕ	ʕ
ʔ	ʔ
h	h
ɦ	ɦ
ɦ̊	ɦ̊
ʹ	́
˜	̃
_ 
=	
·	
+	
,	
`	́
´	̀
ː	ː
#	 
_	 
[	
]	