Grapheme	IPA
a	a
á	á
áa	ā̂
aá	ā̌
aa	ā
i	i
í	í
íi	ī̂
ií	ī̌
ii	ī
u	u
ú	ú
úu	ū̂
uú	ū̌
uu	ū
o	o
ó	ó
oó	ō̌
óo	ō̂
oo	ō
e	e
é	é
eé	ē̌
ée	ē̂
ee	ē
ng	ŋg
k	k
kh	kʰ
g	g
gh	gʰ
č	c
č	c
čh	cʰ
čh	cʰ
ǰ	j
ǰh	jʰ
ṭ	ṭ
ṭh	ṭʰ
ḍ	ḍ
ḍh	ḍʰ
ṇ	ṇ
t	t
th	tʰ
d	d
dh	dʰ
n	n
nh	nʰ
p	p
ph	pʰ
b	b
bh	bʰ
m	m
mh	mʰ
c̣	ʦ̣
c̣h	ʦ̣ʰ
y	y
yh	yʰ
r	r
rh	rʰ
l	l
lh	lʰ
w	v
wh	vʰ
š	ś
ṣ	ṣ
ẓ	ẓ
s	s
sh	sʰ
z	z
ṛ	ṛ
,	,
~	̃
h	h