Grapheme	IPA
'	
ˈ	
.	
ʌ	a
ɑ	ā
ɪ	i
i	ī
ĩ	ī̃
ʊ	u
ʊ̃	ũ
u	ū
ũ	ū̃
e	e
ẽ	ẽ
o	o
õ	õ
oˑ	ō
uˑ	ū
iˑ	ī
č	c
ǰ	j
k	k
g	g
ŋ	ŋ
ṭ	ṭ
ḍ	ḍ
ɠ	ɠ
ɗ	ɗ
ṇ	ṇ
ɽ	ṛ
ɭ	ḷ
t	t
d	d
n	n
p	p
b	b
m	m
y	y
r	r
l	l
w	v
z	z
s	s
š	ś
ṣ̌	ṣ
h	h
ʰ	ʰ
ʱ	ʰ
ɣ	ɣ
æ	æ
č̣	ʦ̣
ỵ	ṛ̌