Grapheme	IPA
p	p
b	b
bh	bʰ
f	f
v	v
w	v
m	m
ü	ü
üː	ǖ
ü	ü
üː	ǖ
úː	ū́
-	
u	u
ö	ö
öː	ȫ
o	o
oː	ō
óː	ṓ
û	ʊ
ô	ɔ
ć	ʦ
ź	ʣ
źh	ʣʰ
t	t
d	d
dh	dʰ
s	s
z	z
l	l
ɬ	ɬ
n	n
c̣	ʦ̣
j̣	ʣ̣
J̣	ʣ̣
j̣h	ʣ̣ʰ
ṭ	ṭ
ḍ	ḍ
ḍh	ḍʰ
ṣ	ṣ
ẓ	ẓ
r	r
ṛ	ṛ
ḷ	ḷ
ř	r̆
ň	r̆̃
ṇ	ṇ
r̥	r̆
č	c
ǰ	j
ǰh	jʰ
š	ś
ž	ź
y	y
i	i
e	e
ä	æ
î	ɪ
ê	ɛ
k̂	kʸ
ĝ	gʸ
ĝh	gʸʰ
k	k
g	g
gh	gʰ
x	x
ǧ	ɣ
ʱ	ʰ
ʷ	ʷ
ŋ	ŋ
ï	ï
ïː	ï̄
a	a
aː	ā
â	å
âː	å̄
å	a
q	q
ḥ	ħ
ʕ	ʕ
ʔ	ʔ
h	h
ɦ	h
ɦ̊	h
ʹ	́
˜	̃
_ 
=	
·	
+	
,	
`	́
´	
#	 
_	 
[	
]	
óː	ṓ
âː	å̄
ǻː	å̄́
íː	ī́
âː	å̄