Grapheme	IPA
ʌ	a
ə	a
a	ā
ɑ	ā
ã	ā̃
ĩ	ĩ
ā	ā
i	i
u	u
ṳ	u
e	e
æ	æ
ɛ	ɛ
o	o
ɔ	ɔ
k	k
x	x
χ	x
g	g
ɣ	ɣ
ŋ	ŋ
ʧ	c
ʦ	ʦ
ʤ	j
ʣ	ʣ
ɲ	ñ
ʈ	ṭ
ɖ	ḍ
ɽ	ṛ
ɻ	ṛ
ɳ	ṇ
t̪	t
d̪	d
t	t
d	d
n	n
p	p
ɸ	ɸ
b	b
β	β
m	m
j	y
r	r
l	l
ɮ	ɮ
ʎ	ʎ
ɭ	ḷ
v	v
w	v
s	s
ʃ	ś
ɕ	ś
z	z
h	h
ʰ	ʰ
ʱ	ʰ
ʲ	ʸ
ʷ	ʷ
̃	̃
-	-
̤	
 	