Grapheme	IPA
ˈ	
.	
ə	a
ə̃	ã
a	ā
ã	ā̃
ã	ā̃
ɪ	i
i	ī
ĩ	ī̃
ʊ	u
ʊ̃	ũ
u	ū
ũ	ū̃
e	e
ẽ	ẽ
o	o
õ	õ
dʒ	j
k	k
ɡ	g
ŋ	ŋ
ʈ	ṭ
ɓ	ɓ
ɖ	ḍ
ᶑ	ᶑ
ɠ	ɠ
ɗ	ɗ
ɳ	ṇ
ɽ	ṛ
ɭ	ḷ
t	t
d	d
n	n
p	p
b	b
m	m
j	y
ɾ	r
l	l
w	v
z	z
s	s
ʃ	ś
ɦ	h
ʰ	ʰ
ʱ	ʰ