Grapheme	IPA
ṁ	ɴ
ṃ	ɴ
a	ə
á	ə́
à	ə̂
ā	aː
ā́	áː
ā̀	âː
i	i
í	í
ī	iː
ī́	íː
u	u
ú	ú
ū	uː
ū́	úː
ū̀	ûː
ē	əi̯
ḗ	ə́i̯
ḕ	ə̂i̯
ō	əu̯
ṓ	ə́u̯
ai	aːi̯
au	aːu̯
r̥	r̩
ŕ̊	ŕ̩
k	k
kh	kʰ
g	g
gh	gʱ
ṅ	ŋ
c	t͡ʃ
ch	t͡ʃʰ
j	d͡ʒ
jh	d͡ʒʱ
ñ	ɲ
t	t̪
th	t̪ʰ
d	d̪
dh	d̪ʱ
n	n
ṭ	ʈ
ṭh	ʈʰ
ḍ	ɖ
ḍh	ɖʱ
ṇ	ɳ
p	p
ph	pʰ
b	b
bh	bʱ
y	j
r	ɾ
l	l
v	ʋ
w	ʋ
s	s
ś	ʃ
ṣ	ʂ
h	ɦ
ṛ	ɽ
m	m
-	
ḥ	h
1	
2	
3	
4	
5	
6	