Grapheme	IPA
ṁ	ɴ
ṃ	ɴ
a	ə
ā	aː
i	ɪ
ï	ɪ
ī	iː
u	ʊ
ü	ʊ
ũ	ʊ̃
ū	uː
e	e
ē	eː
o	o
ō	oː
k	k
kh	kʰ
g	g
gh	gʱ
ṅ	ŋ
c	t͡ʃ
ch	t͡ʃʰ
j	d͡ʒ
jh	d͡ʒʱ
ñ	ɲ
t	t̪
th	t̪ʰ
d	d̪
dh	d̪ʱ
n	n
ṭ	ʈ
ṭh	ʈʰ
ḍ	ɖ
ḍh	ɖʱ
ṇ	ɳ
p	p
ph	pʰ
b	b
bh	bʱ
y	j
r	ɾ
l	l
v	ʋ
w	ʋ
s	s
ś	ʃ
ṣ	ʂ
h	ɦ
ṛ	ɽ
m	m
–	
ḷ	ɭ